22222223222322233222322232233323
22200000000000000000000000022322
22000020000000000000002000000032
20000000000003000000000000000023
30000000000000000000300000000002
20000000300000000000000022000003
20000000000000000000000030000003
30000000000000000000000330000003
20002000300000000000000000000003
20000000000000030000000000000003
20000000000000000000002000000002
20000300000003000000000000000002
30000000001111333300000000000002
22000000011111113300000000000023
22200000111111113300000000002232
22233322322232232232232223223232
